NO ../numberset.xpm
SO			../test.xpm
EA ../numberset.xpm

F 220,255,0
C 255,30,0

WE ../test.xpm
1000000000000000
10000000000000000
11111111111
000000000000111111111111111


