NO ../numberset.xpm


    SO ../test.xpm

                    


F 220,100,0
C 255,255,0,

WE     ../test.xpm
EA ../numberset.xpm





              1000000000000000
10000000000000000
11111111111
000000000000111111111111111

