NO ./texture/wall1.xpm
SO ./texture/wall2.xpm
WE ./texture/wall3.xpm
EA ./texture/wall4.xpm

F 220,100,0
C 225,30,0
1111111111111111111111111
1000000000001000000000001
1000000000001111111111111
1000000000000000000000001
1000000000000000000000001
11111111001000000000000W1
1000001000010000000000001
1111111111111111111111111