NO ./numberset.xpm
SO ./numberset.xpm
WE ./numberset.xpm
EA ./numberset.xpm

F 220,100,0
C 225,30,0

1111111111111111111111111
1000000000001000000000001
1000000000001111111111111
1000000000000000000000001
1000000000000000000000001
11111111001N0000000000001
1000001000010000000000001
1111111111111111111111111
