NO ./numberset.xpm
SO ./numberset.xpm
WE ./numberset.xpm
EA ./numberset.xpm

F 220,100,0
C 225,30,0


1111111111
10000100111
1000010000011111
1000000000000001
1E00000001111111
111111111 

