NO ./texture/wall2.xpm
SO ./texture/wall1.xpm
WE ./texture/wall3.xpm
EA ./texture/wall4.xpm

F 153,102,51
C 204,230,255

        11111111111111111
        111111111000000001
        1111111110010000001
        10111111100000001001
        100111000000000010001
11111111101100000000000001001
100000000011000000000000110111111
11110111111111000000000011001
11110111111111000000000011001
11110111111111000000000011001
11000000110101000000000011001
10000000000000000000000011001
10000000000000000001010010001
1100000111010100000111110N111
11110111 11101011101111011001 
11111111 1111111 111111111111