NO ./texture/wall_snow.xpm
SO ./texture/wall_night.xpm
WE ./texture/wall3.xpm
EA ./texture/wall4.xpm

F 153,102,51
C 204,230,255

                               11111111111111111111111111111111111111111111111
                            11110000000000000000000000000000000000000000000011111111 
                           11110000000000000000000000000000000000000000000011111111
                          111100000111111110000000000000000000111111110000000011111111
                        11111000001000000001000000000000000001000000001000000000011111111
                       111110000010000000000100000000100000010000000000100000000000011111111
                    111111000000100000000000010000000000000100000000000010000000000011111111
                 1111111100000001100000000000010000000000010000000000001110000000000011111111
                  11111000000000001110000000000100000000010000000000111110000000000000011111111
                  111100000000000000001111000000100000001100000001111111000000000000000011111111
                  11110000000000000000001111001001010001000000001111111100000000000000000011111111
                1111100000000000000000000111100001100011000000010000000000000000000000000011111111
                1111100000000000000000000001111111000011110000100000000000000000000000000000011111111
               1111100000000000000000000000000011000000111111100000000000000000000000000000011111111
               11111000000000000000100000000000100000000001000000000000000000000000000000011111111
              11111110000000000000000000000000100000000001000000000000000000000000000000011111111
              111111100000000000001000000000000010000000110000000000000000000000000000000011111111
                  1111000000000000000000000000001111111100000000000000000000000000000000011111111
                    1100000000000010000000000000000000100000000000000100000000000000000011111111
                     1100000000000000000000000000000010010000000000000N0000000000000011111111
                     11110000000000000000000000000000000000000000000000000000000000011111111
                     11111000000000000000000000000000000000000000000000000000000000011111111
                      1111100000000000000000000000000000100000000000000000000000011111111
                        111100000000000000000000000000000000000000000000000000011111111
                         111000000000000000000000000010000000000000000000000011111111
                         1111110000000000000000000000000000000000000000000011111111
                          111111000010000000000000000000000000000000000000011111111
                           11111100000000000000000000000000000000000000011111111
                             111111000000000000000000000000000000000011111111
                                111111000000000000000000000000000011111111
                                     111111111111111111111111111111111