NO ./texture/wall1.xpm
SO ./texture/wall2.xpm
WE ./texture/wall3.xpm
EA ./texture/wall4.xpm

F 153,102,51
C 204,230,255

                111111111111111111111111111
         11111111
       11111111
        111111        
       111111
      111111
     111111
    111111
    111111
   111111
  111111
  111111
  111111
  111111
   111111
   111111
    111111
    111111
     111111
       111111
        111111
         111111
           111111
             111111
              111111
               111111
                111111
                 111111
